"","stake","date","name","buy","sell","total"
"1","4903聯光通","110/07/08","元富-新興",18,0,18
"2","4903聯光通","110/07/08","中國信託-中壢",0,14,-14
"3","4903聯光通","110/07/08","元大-苗栗",9,0,9
"4","4903聯光通","110/07/08","彰銀",0,7,-7
"5","4903聯光通","110/07/08","兆豐-鹿港",3,0,3
"6","4903聯光通","110/07/08","中國信託-松江",0,5,-5
"7","4903聯光通","110/07/08","群益金鼎-萬華",2,0,2
"8","4903聯光通","110/07/08","光和",0,2,-2
"9","4903聯光通","110/07/08","元大-屏南",1,0,1
"10","4903聯光通","110/07/08","元大-鶯歌",0,2,-2
"11","4903聯光通","110/07/08","華南永昌-新莊",0,0,0
"12","4903聯光通","110/07/08","群益金鼎-館前",0,1,-1
"13","4903聯光通","110/07/08","元大-羅東",0,0,0
"14","4903聯光通","110/07/08","華南永昌",0,1,-1
"16","4903聯光通","110/07/08","元大-太平",2,3,-1
"18","4903聯光通","110/07/08","華南永昌-新莊",0,0,0
"20","4903聯光通","110/07/08","元大-羅東",0,0,0
"31","2929淘帝","110/07/08","日盛-園區",90,6,84
"32","2929淘帝","110/07/08","元大-太平",1,111,-110
"33","2929淘帝","110/07/08","華南永昌-頭份",54,0,54
"34","2929淘帝","110/07/08","港商野村",31,106,-75
"35","2929淘帝","110/07/08","美商高盛",50,0,50
"36","2929淘帝","110/07/08","凱基-板橋",62,111,-49
"37","2929淘帝","110/07/08","台中銀-台北",50,0,50
"38","2929淘帝","110/07/08","新光-台中",30,78,-48
"39","2929淘帝","110/07/08","臺銀-臺南",30,0,30
"40","2929淘帝","110/07/08","元富-永和",1,41,-40
"41","2929淘帝","110/07/08","永豐金-大園",42,12,30
"42","2929淘帝","110/07/08","永豐金-鳳山",0,28,-28
"43","2929淘帝","110/07/08","元富-三重",30,1,29
"44","2929淘帝","110/07/08","元大-南崁",0,26,-26
"45","2929淘帝","110/07/08","兆豐-桃鶯",29,0,29
"46","2929淘帝","110/07/08","元大-花蓮",2,27,-25
"47","2929淘帝","110/07/08","元大-承德",20,3,17
"48","2929淘帝","110/07/08","元大-府城",0,24,-24
"49","2929淘帝","110/07/08","新光-新竹",13,0,13
"50","2929淘帝","110/07/08","新光",21,43,-22
"51","2929淘帝","110/07/08","富邦-內湖",13,0,13
"52","2929淘帝","110/07/08","臺銀-民權",0,20,-20
"53","2929淘帝","110/07/08","國泰-板橋",13,1,12
"54","2929淘帝","110/07/08","摩根大通",66,84,-18
"55","2929淘帝","110/07/08","第一金-大稻埕",10,0,10
"56","2929淘帝","110/07/08","凱基-台北",0,17,-17
"57","2929淘帝","110/07/08","統一-汐止",10,0,10
"58","2929淘帝","110/07/08","元大-博愛",6,23,-17
"59","2929淘帝","110/07/08","元富-大裕",10,0,10
"60","2929淘帝","110/07/08","永豐金-桃盛",0,16,-16
"61","5410國眾","110/07/08","元大-新盛",15,0,15
"62","5410國眾","110/07/08","元大-旗山",0,50,-50
"63","5410國眾","110/07/08","元大-屏南",10,0,10
"64","5410國眾","110/07/08","元大-頭份",0,14,-14
"65","5410國眾","110/07/08","元大-成功",10,0,10
"66","5410國眾","110/07/08","國泰-高雄",0,8,-8
"67","5410國眾","110/07/08","元大-東泰",7,0,7
"68","5410國眾","110/07/08","元大-小港",0,7,-7
"69","5410國眾","110/07/08","富邦-陽明",6,0,6
"70","5410國眾","110/07/08","統一-嘉義",0,5,-5
"71","5410國眾","110/07/08","臺銀-金山",5,0,5
"72","5410國眾","110/07/08","兆豐-台中港",0,5,-5
"73","5410國眾","110/07/08","日盛-員林",5,0,5
"74","5410國眾","110/07/08","凱基-屏東",0,5,-5
"75","5410國眾","110/07/08","摩根大通",5,0,5
"76","5410國眾","110/07/08","元大-八德",0,5,-5
"77","5410國眾","110/07/08","富邦-桃園",5,0,5
"78","5410國眾","110/07/08","元富-嘉義",0,4,-4
"79","5410國眾","110/07/08","元富-大昌",4,0,4
"80","5410國眾","110/07/08","玉山-雙和",0,4,-4
"81","5410國眾","110/07/08","台新-台中",4,0,4
"82","5410國眾","110/07/08","凱基-高美館",1,5,-4
"83","5410國眾","110/07/08","華南永昌-小港",5,1,4
"84","5410國眾","110/07/08","統一-員林",0,3,-3
"85","5410國眾","110/07/08","元大-新竹",5,1,4
"86","5410國眾","110/07/08","臺銀-鳳山",0,2,-2
"87","5410國眾","110/07/08","元大-土城學府",4,0,4
"88","5410國眾","110/07/08","亞東",0,2,-2
"89","5410國眾","110/07/08","元大-新莊",4,0,4
"90","5410國眾","110/07/08","新光",0,2,-2
"91","2841台開","110/07/08","元大-樹林",653,0,653
"92","2841台開","110/07/08","港商野村",0,868,-868
"93","2841台開","110/07/08","台新證券",115,0,115
"94","2841台開","110/07/08","群益金鼎-忠孝",0,100,-100
"95","2841台開","110/07/08","永豐金-豐原",105,0,105
"96","2841台開","110/07/08","宏遠-高雄",0,56,-56
"97","2841台開","110/07/08","元富-新興",100,0,100
"98","2841台開","110/07/08","新光",3,38,-35
"99","2841台開","110/07/08","凱基-文心",50,0,50
"100","2841台開","110/07/08","花旗環球",0,29,-29
"101","2841台開","110/07/08","元大-八德",40,0,40
"102","2841台開","110/07/08","富邦-仁愛",2,30,-28
"103","2841台開","110/07/08","日盛-雙和",30,0,30
"104","2841台開","110/07/08","元富-潮州",0,24,-24
"105","2841台開","110/07/08","統一-竹南",30,0,30
"106","2841台開","110/07/08","元大-沙鹿",0,20,-20
"107","2841台開","110/07/08","凱基-台南",30,0,30
"108","2841台開","110/07/08","元大-汐止",0,20,-20
"109","2841台開","110/07/08","元大-福營",30,0,30
"110","2841台開","110/07/08","合庫-嘉義",2,20,-18
"111","2841台開","110/07/08","合庫-台中",22,0,22
"112","2841台開","110/07/08","國泰-敦南",3,21,-18
"113","2841台開","110/07/08","大昌-安康",28,10,18
"114","2841台開","110/07/08","日盛-竹北",0,15,-15
"115","2841台開","110/07/08","元大-斗信",15,0,15
"116","2841台開","110/07/08","元大-三重",0,15,-15
"117","2841台開","110/07/08","富邦-台北",13,0,13
"118","2841台開","110/07/08","永豐金-敦南",45,60,-15
"119","2841台開","110/07/08","合庫-桃園",10,0,10
"120","2841台開","110/07/08","(牛牛牛)亞-網路",0,12,-12
"121","6207雷科","110/07/08","台新-高雄",54,2,52
"122","6207雷科","110/07/08","群益金鼎-丹鳳",0,60,-60
"123","6207雷科","110/07/08","新光-台中",18,0,18
"124","6207雷科","110/07/08","元大-頭份",1,56,-55
"125","6207雷科","110/07/08","日盛-嘉義",16,0,16
"126","6207雷科","110/07/08","國票-中和",0,30,-30
"127","6207雷科","110/07/08","合庫-鳳山",15,0,15
"128","6207雷科","110/07/08","凱基-台北",1,29,-28
"129","6207雷科","110/07/08","臺銀-臺中",12,0,12
"130","6207雷科","110/07/08","兆豐-板橋",0,25,-25
"131","6207雷科","110/07/08","群益金鼎-土城",12,0,12
"132","6207雷科","110/07/08","凱基-城中",4,25,-21
"133","6207雷科","110/07/08","新光",25,14,11
"134","6207雷科","110/07/08","日進",0,20,-20
"135","6207雷科","110/07/08","凱基-中壢",11,0,11
"136","6207雷科","110/07/08","台新證券",3,20,-17
"137","6207雷科","110/07/08","台灣企銀",10,0,10
"138","6207雷科","110/07/08","群益金鼎-中山",0,16,-16
"139","6207雷科","110/07/08","第一金-新興",11,1,10
"140","6207雷科","110/07/08","元大-東門",0,16,-16
"141","6207雷科","110/07/08","元富-吉利",10,0,10
"142","6207雷科","110/07/08","群益金鼎-大甲",0,13,-13
"143","6207雷科","110/07/08","光和-和美",10,0,10
"144","6207雷科","110/07/08","日盛-板橋",0,10,-10
"145","6207雷科","110/07/08","永豐金-南京",10,0,10
"146","6207雷科","110/07/08","日盛-中壢",0,10,-10
"147","6207雷科","110/07/08","土銀",8,0,8
"148","6207雷科","110/07/08","摩根大通",125,135,-10
"149","6207雷科","110/07/08","中國信託-高雄",8,0,8
"150","6207雷科","110/07/08","凱基-五股",0,10,-10
"151","3679新至陞","110/07/08","華南永昌-台中",17,0,17
"152","3679新至陞","110/07/08","大慶-蘆洲",0,10,-10
"153","3679新至陞","110/07/08","國泰-桃園",6,0,6
"154","3679新至陞","110/07/08","華南永昌-小港",0,7,-7
"155","3679新至陞","110/07/08","元大-永春",6,0,6
"156","3679新至陞","110/07/08","國泰-館前",0,3,-3
"157","3679新至陞","110/07/08","香港上海匯豐",4,0,4
"158","3679新至陞","110/07/08","元大-板橋",0,3,-3
"159","3679新至陞","110/07/08","中國信託-新竹",3,0,3
"160","3679新至陞","110/07/08","港商法國興業",0,2,-2
"161","3679新至陞","110/07/08","國票-敦北法人",3,0,3
"162","3679新至陞","110/07/08","第一金-忠孝",0,2,-2
"163","3679新至陞","110/07/08","群益金鼎-台南",2,0,2
"164","3679新至陞","110/07/08","元富-古亭",0,2,-2
"165","3679新至陞","110/07/08","凱基",2,0,2
"166","3679新至陞","110/07/08","摩根大通",1,3,-2
"167","3679新至陞","110/07/08","凱基-台北",6,4,2
"168","3679新至陞","110/07/08","富邦-板橋",0,2,-2
"169","3679新至陞","110/07/08","日盛-信義",1,0,1
"170","3679新至陞","110/07/08","元大-文心興安",0,2,-2
"171","3679新至陞","110/07/08","日盛-新莊",1,0,1
"172","3679新至陞","110/07/08","臺銀-高雄",0,1,-1
"173","3679新至陞","110/07/08","大慶",1,0,1
"174","3679新至陞","110/07/08","日盛-高雄",0,1,-1
"175","3679新至陞","110/07/08","兆豐-三重",1,0,1
"176","3679新至陞","110/07/08","日盛-文化",0,1,-1
"177","3679新至陞","110/07/08","致和-東門",1,0,1
"178","3679新至陞","110/07/08","美商高盛",0,1,-1
"179","3679新至陞","110/07/08","台新證券",1,0,1
"180","3679新至陞","110/07/08","瑞士信貸",0,1,-1
"181","2727王品","110/07/08","群益金鼎-大安",80,0,80
"182","2727王品","110/07/08","台灣摩根士丹利",1,300,-299
"183","2727王品","110/07/08","富邦-台北",237,165,72
"184","2727王品","110/07/08","元大證券",173,439,-266
"185","2727王品","110/07/08","永豐金-萬盛",55,5,50
"186","2727王品","110/07/08","統一",33,200,-167
"187","2727王品","110/07/08","永豐金-南投",53,10,43
"188","2727王品","110/07/08","凱基-台北",476,615,-139
"189","2727王品","110/07/08","國泰-敦南",190,148,42
"190","2727王品","110/07/08","永豐金-松山",8,138,-130
"191","2727王品","110/07/08","台新-高雄",71,36,35
"192","2727王品","110/07/08","新加坡商瑞銀",38,138,-100
"193","2727王品","110/07/08","富邦-建國",62,27,35
"194","2727王品","110/07/08","富邦-嘉義",84,182,-98
"195","2727王品","110/07/08","永豐金證券",50,15,35
"196","2727王品","110/07/08","元富-台南",4,99,-95
"197","2727王品","110/07/08","港商野村",185,152,33
"198","2727王品","110/07/08","凱基-永華",4,92,-88
"199","2727王品","110/07/08","元大-嘉義",35,3,32
"200","2727王品","110/07/08","凱基-大直",2,73,-71
"201","2727王品","110/07/08","台新-三民",35,4,31
"202","2727王品","110/07/08","美林",105,164,-59
"203","2727王品","110/07/08","凱基-桃園",35,4,31
"204","2727王品","110/07/08","第一金-台南",11,63,-52
"205","2727王品","110/07/08","元大-和平",41,10,31
"206","2727王品","110/07/08","摩根大通",216,259,-43
"207","2727王品","110/07/08","兆豐-大安",33,5,28
"208","2727王品","110/07/08","元大-員林",9,50,-41
"209","2727王品","110/07/08","元大-新盛",33,6,27
"210","2727王品","110/07/08","兆豐-虎尾",1,41,-40
"211","1570力肯","110/07/08","群益金鼎-三重",20,0,20
"212","1570力肯","110/07/08","中國信託-永康",0,26,-26
"213","1570力肯","110/07/08","凱基-中壢",20,0,20
"214","1570力肯","110/07/08","統一-敦南",0,12,-12
"215","1570力肯","110/07/08","群益金鼎-台南",14,0,14
"216","1570力肯","110/07/08","國票-博愛",0,10,-10
"217","1570力肯","110/07/08","元富-緯城",10,0,10
"218","1570力肯","110/07/08","元大-西門",0,10,-10
"219","1570力肯","110/07/08","瑞士信貸",7,0,7
"220","1570力肯","110/07/08","新光",0,9,-9
"221","1570力肯","110/07/08","摩根大通",6,0,6
"222","1570力肯","110/07/08","永豐金-大園",0,9,-9
"223","1570力肯","110/07/08","土銀-白河",5,0,5
"224","1570力肯","110/07/08","日盛-大墩",0,6,-6
"225","1570力肯","110/07/08","台灣摩根士丹利",4,0,4
"226","1570力肯","110/07/08","台新證券",0,6,-6
"227","1570力肯","110/07/08","元大-新莊",3,0,3
"228","1570力肯","110/07/08","永全",0,5,-5
"229","1570力肯","110/07/08","永豐金-苓雅",3,0,3
"230","1570力肯","110/07/08","元大-天母",0,5,-5
"231","1570力肯","110/07/08","合庫-三重",2,0,2
"232","1570力肯","110/07/08","元富-吉利",0,3,-3
"233","1570力肯","110/07/08","(牛牛牛)亞-鑫豐",2,0,2
"234","1570力肯","110/07/08","國泰-高雄",0,3,-3
"235","1570力肯","110/07/08","玉山-大里",2,0,2
"236","1570力肯","110/07/08","群益金鼎-北高雄",0,3,-3
"237","1570力肯","110/07/08","國泰-敦南",2,0,2
"238","1570力肯","110/07/08","群益金鼎-東門",0,2,-2
"239","1570力肯","110/07/08","華南永昌-岡山",2,0,2
"240","1570力肯","110/07/08","日盛-高雄",5,6,-1
"241","6180橘子","110/07/08","新光",30,4,26
"242","6180橘子","110/07/08","元大-土城學府",0,89,-89
"243","6180橘子","110/07/08","康和-台南",22,0,22
"244","6180橘子","110/07/08","凱基-東勢",1,66,-65
"245","6180橘子","110/07/08","國泰-板橋",22,0,22
"246","6180橘子","110/07/08","光和",0,64,-64
"247","6180橘子","110/07/08","日盛-文化",21,0,21
"248","6180橘子","110/07/08","中國信託-忠孝",0,50,-50
"249","6180橘子","110/07/08","中國信託-文心",20,2,18
"250","6180橘子","110/07/08","元富-大裕",0,25,-25
"251","6180橘子","110/07/08","凱基-台北",39,24,15
"252","6180橘子","110/07/08","統一-基隆",1,25,-24
"253","6180橘子","110/07/08","元富-新店",14,0,14
"254","6180橘子","110/07/08","美商高盛",1,21,-20
"255","6180橘子","110/07/08","元大-土城永寧",11,0,11
"256","6180橘子","110/07/08","元大證券",1,19,-18
"257","6180橘子","110/07/08","永豐金-南京",11,0,11
"258","6180橘子","110/07/08","元大-太平",2,20,-18
"259","6180橘子","110/07/08","宏遠-館前",10,0,10
"260","6180橘子","110/07/08","合庫證券",2,18,-16
"261","6180橘子","110/07/08","國泰-新莊",10,0,10
"262","6180橘子","110/07/08","台灣摩根士丹利",1,12,-11
"263","6180橘子","110/07/08","群益金鼎",10,0,10
"264","6180橘子","110/07/08","瑞士信貸",0,11,-11
"265","6180橘子","110/07/08","凱基-高雄",10,0,10
"266","6180橘子","110/07/08","元富-嘉義",0,11,-11
"267","6180橘子","110/07/08","凱基-大安",10,0,10
"268","6180橘子","110/07/08","新光-高雄",0,11,-11
"269","6180橘子","110/07/08","富邦-仁愛",10,0,10
"270","6180橘子","110/07/08","大慶-苗栗",0,10,-10
"271","2390云辰","110/07/08","統一-新台中",126,1,125
"272","2390云辰","110/07/08","摩根大通",62,661,-599
"273","2390云辰","110/07/08","元大-員林",111,0,111
"274","2390云辰","110/07/08","新加坡商瑞銀",0,173,-173
"275","2390云辰","110/07/08","合庫-高雄",105,0,105
"276","2390云辰","110/07/08","元大-天母",7,150,-143
"277","2390云辰","110/07/08","凱基-台北",255,177,78
"278","2390云辰","110/07/08","台灣摩根士丹利",0,134,-134
"279","2390云辰","110/07/08","新光",71,17,54
"280","2390云辰","110/07/08","玉山-台中",17,120,-103
"281","2390云辰","110/07/08","國票-嘉義",53,0,53
"282","2390云辰","110/07/08","美商高盛",0,78,-78
"283","2390云辰","110/07/08","富邦-仁愛",53,4,49
"284","2390云辰","110/07/08","美林",11,82,-71
"285","2390云辰","110/07/08","兆豐-城中",48,0,48
"286","2390云辰","110/07/08","群益金鼎-大興",35,106,-71
"287","2390云辰","110/07/08","元大-新營",47,0,47
"288","2390云辰","110/07/08","光和",11,71,-60
"289","2390云辰","110/07/08","國泰-敦南",89,55,34
"290","2390云辰","110/07/08","國泰-台中",28,70,-42
"291","2390云辰","110/07/08","兆豐-台中",40,7,33
"292","2390云辰","110/07/08","玉山-新莊",6,46,-40
"293","2390云辰","110/07/08","永豐金-中正",36,6,30
"294","2390云辰","110/07/08","富邦-台北",21,57,-36
"295","2390云辰","110/07/08","中國信託-三重",29,0,29
"296","2390云辰","110/07/08","土銀-台中",0,30,-30
"297","2390云辰","110/07/08","富邦-陽明",33,5,28
"298","2390云辰","110/07/08","兆豐-埔墘",1,31,-30
"299","2390云辰","110/07/08","元富-桃園",27,0,27
"300","2390云辰","110/07/08","玉山-南京東路",3,33,-30
"301","4903聯光通","110/07/06","元大-太平",47,4,43
"302","4903聯光通","110/07/06","日盛-板橋",0,15,-15
"303","4903聯光通","110/07/06","華南永昌-桃園",10,0,10
"304","4903聯光通","110/07/06","元大-八德",0,9,-9
"305","4903聯光通","110/07/06","元大-南投",9,0,9
"306","4903聯光通","110/07/06","宏遠證券",0,7,-7
"307","4903聯光通","110/07/06","新光-台中",3,0,3
"308","4903聯光通","110/07/06","大慶",0,7,-7
"309","4903聯光通","110/07/06","國泰-敦南",1,0,1
"310","4903聯光通","110/07/06","群益金鼎-館前",0,6,-6
"311","4903聯光通","110/07/06","國票-中正",0,0,0
"312","4903聯光通","110/07/06","元大-羅東",0,5,-5
"313","4903聯光通","110/07/06","康和-內湖",0,0,0
"314","4903聯光通","110/07/06","新光",8,12,-4
"315","4903聯光通","110/07/06","凱基-站前",0,0,0
"316","4903聯光通","110/07/06","國泰-高雄",0,3,-3
"317","4903聯光通","110/07/06","華南永昌",1,1,0
"318","4903聯光通","110/07/06","第一金-台中",0,3,-3
"319","4903聯光通","110/07/06","華南永昌-新莊",0,0,0
"320","4903聯光通","110/07/06","中農",0,1,-1
"322","4903聯光通","110/07/06","臺灣企銀-桃園",0,1,-1
"324","4903聯光通","110/07/06","台新-新營",0,1,-1
"326","4903聯光通","110/07/06","元大-鶯歌",2,3,-1
"328","4903聯光通","110/07/06","元大-永和",0,1,-1
"330","4903聯光通","110/07/06","元大-苑裡",0,1,-1
"331","2929淘帝","110/07/06","統一",163,0,163
"332","2929淘帝","110/07/06","新光-台中",57,142,-85
"333","2929淘帝","110/07/06","港商野村",323,181,142
"334","2929淘帝","110/07/06","兆豐-忠孝",0,76,-76
"335","2929淘帝","110/07/06","日盛-中壢",132,10,122
"336","2929淘帝","110/07/06","台新-建北",0,53,-53
"337","2929淘帝","110/07/06","新加坡商瑞銀",140,19,121
"338","2929淘帝","110/07/06","臺銀-鳳山",0,44,-44
"339","2929淘帝","110/07/06","日盛-嘉義",101,0,101
"340","2929淘帝","110/07/06","元大-新盛",0,42,-42
"341","2929淘帝","110/07/06","摩根大通",101,16,85
"342","2929淘帝","110/07/06","富邦-建國",6,47,-41
"343","2929淘帝","110/07/06","元大-太平",55,2,53
"344","2929淘帝","110/07/06","日盛-園區",0,40,-40
"345","2929淘帝","110/07/06","元富-松德",50,1,49
"346","2929淘帝","110/07/06","新光-高雄",1,38,-37
"347","2929淘帝","110/07/06","凱基-板橋",53,5,48
"348","2929淘帝","110/07/06","永豐金-三重",1,34,-33
"349","2929淘帝","110/07/06","美林",80,34,46
"350","2929淘帝","110/07/06","元大-彰化",0,31,-31
"351","2929淘帝","110/07/06","元富-台南",41,0,41
"352","2929淘帝","110/07/06","第一金-大稻埕",0,30,-30
"353","2929淘帝","110/07/06","兆豐-竹北",39,0,39
"354","2929淘帝","110/07/06","國泰-敦南",3,33,-30
"355","2929淘帝","110/07/06","元大-西門",36,0,36
"356","2929淘帝","110/07/06","富邦-員林",0,30,-30
"357","2929淘帝","110/07/06","華南永昌",39,4,35
"358","2929淘帝","110/07/06","元大-蘆洲",1,30,-29
"359","2929淘帝","110/07/06","日盛-板橋中山",30,0,30
"360","2929淘帝","110/07/06","台新-台南",4,32,-28
"361","5410國眾","110/07/06","兆豐-城中",66,0,66
"362","5410國眾","110/07/06","富邦-仁愛",0,115,-115
"363","5410國眾","110/07/06","摩根大通",21,0,21
"364","5410國眾","110/07/06","亞東-板橋",0,38,-38
"365","5410國眾","110/07/06","元大-北投",21,0,21
"366","5410國眾","110/07/06","凱基-台北",2,24,-22
"367","5410國眾","110/07/06","亞東-新竹",15,0,15
"368","5410國眾","110/07/06","彰銀-七賢",0,10,-10
"369","5410國眾","110/07/06","元大-福營",12,0,12
"370","5410國眾","110/07/06","凱基-基隆",0,10,-10
"371","5410國眾","110/07/06","新光-高雄",11,0,11
"372","5410國眾","110/07/06","凱基-屏東",0,10,-10
"373","5410國眾","110/07/06","華南永昌-小港",10,0,10
"374","5410國眾","110/07/06","凱基-鳳山",0,10,-10
"375","5410國眾","110/07/06","元大-大灣",10,0,10
"376","5410國眾","110/07/06","永豐金-忠孝",0,10,-10
"377","5410國眾","110/07/06","元大-莒光",10,0,10
"378","5410國眾","110/07/06","日盛-板橋中山",0,9,-9
"379","5410國眾","110/07/06","台中銀-豐原",9,0,9
"380","5410國眾","110/07/06","統一-高雄",0,5,-5
"381","5410國眾","110/07/06","元大-南屯",9,0,9
"382","5410國眾","110/07/06","元大-斗六",0,5,-5
"383","5410國眾","110/07/06","日盛-新莊",7,0,7
"384","5410國眾","110/07/06","元大-大益",0,5,-5
"385","5410國眾","110/07/06","元富-大昌",6,0,6
"386","5410國眾","110/07/06","元大-南投",0,5,-5
"387","5410國眾","110/07/06","新光-新竹",6,0,6
"388","5410國眾","110/07/06","永豐金-員林",0,5,-5
"389","5410國眾","110/07/06","臺銀-金山",5,0,5
"390","5410國眾","110/07/06","華南永昌-楠梓",0,4,-4
"391","2841台開","110/07/06","永豐金-豐原",268,0,268
"392","2841台開","110/07/06","凱基-市政",0,200,-200
"393","2841台開","110/07/06","永豐金-南投",200,0,200
"394","2841台開","110/07/06","永豐金-彰化",0,100,-100
"395","2841台開","110/07/06","新光",139,9,130
"396","2841台開","110/07/06","元大-開元",1,93,-92
"397","2841台開","110/07/06","中國信託-高雄",50,1,49
"398","2841台開","110/07/06","港商野村",0,80,-80
"399","2841台開","110/07/06","元大-歸仁",40,0,40
"400","2841台開","110/07/06","凱基-台南",25,85,-60
"401","2841台開","110/07/06","台中銀",35,0,35
"402","2841台開","110/07/06","美商高盛",1,58,-57
"403","2841台開","110/07/06","台新-新營",30,0,30
"404","2841台開","110/07/06","統一-三重",0,55,-55
"405","2841台開","110/07/06","富邦-台南",30,0,30
"406","2841台開","110/07/06","台新證券",12,50,-38
"407","2841台開","110/07/06","國泰-板橋",30,1,29
"408","2841台開","110/07/06","陽信-石牌",0,31,-31
"409","2841台開","110/07/06","凱基-文心",28,0,28
"410","2841台開","110/07/06","元大-福營",0,31,-31
"411","2841台開","110/07/06","凱基-站前",27,0,27
"412","2841台開","110/07/06","第一金-澎湖",0,30,-30
"413","2841台開","110/07/06","大昌-安康",38,16,22
"414","2841台開","110/07/06","元大-新莊",0,30,-30
"415","2841台開","110/07/06","合庫-台中",20,0,20
"416","2841台開","110/07/06","國泰-館前",0,28,-28
"417","2841台開","110/07/06","日盛-台南",20,0,20
"418","2841台開","110/07/06","元大-竹科",0,25,-25
"419","2841台開","110/07/06","台中銀-員林",20,0,20
"420","2841台開","110/07/06","富邦-仁愛",1,22,-21
"421","6207雷科","110/07/06","元大-大天母",21,0,21
"422","6207雷科","110/07/06","元大-高雄",0,105,-105
"423","6207雷科","110/07/06","元大-頭份",18,0,18
"424","6207雷科","110/07/06","永豐金-中正",0,35,-35
"425","6207雷科","110/07/06","第一金-新興",16,0,16
"426","6207雷科","110/07/06","摩根大通",8,39,-31
"427","6207雷科","110/07/06","富邦-虎尾",12,0,12
"428","6207雷科","110/07/06","元大-林園",0,30,-30
"429","6207雷科","110/07/06","兆豐-板橋",10,0,10
"430","6207雷科","110/07/06","凱基-台北",0,19,-19
"431","6207雷科","110/07/06","玉山-台大",10,0,10
"432","6207雷科","110/07/06","國票-中和",13,25,-12
"433","6207雷科","110/07/06","元大-四維",10,0,10
"434","6207雷科","110/07/06","新加坡商瑞銀",0,9,-9
"435","6207雷科","110/07/06","元大-鹿港",10,0,10
"436","6207雷科","110/07/06","玉山-高雄",0,8,-8
"437","6207雷科","110/07/06","元大-信義",10,0,10
"438","6207雷科","110/07/06","玉山-台南",0,8,-8
"439","6207雷科","110/07/06","台新-三民",8,0,8
"440","6207雷科","110/07/06","宏遠-高雄",0,5,-5
"441","6207雷科","110/07/06","元大-上新莊",8,0,8
"442","6207雷科","110/07/06","元大-南海",0,5,-5
"443","6207雷科","110/07/06","大昌-桃園",7,0,7
"444","6207雷科","110/07/06","元大-莒光",0,4,-4
"445","6207雷科","110/07/06","新光-台中",10,4,6
"446","6207雷科","110/07/06","港商野村",0,3,-3
"447","6207雷科","110/07/06","日盛-頭份",5,0,5
"448","6207雷科","110/07/06","大慶-台南",0,3,-3
"449","6207雷科","110/07/06","日茂-埔里",5,0,5
"450","6207雷科","110/07/06","凱基-站前",0,3,-3
"451","3679新至陞","110/07/06","永豐金證券",18,0,18
"452","3679新至陞","110/07/06","美林",0,13,-13
"453","3679新至陞","110/07/06","元大-文心興安",6,0,6
"454","3679新至陞","110/07/06","兆豐-大安",0,10,-10
"455","3679新至陞","110/07/06","中農",5,0,5
"456","3679新至陞","110/07/06","國泰-桃園",0,4,-4
"457","3679新至陞","110/07/06","台新證券",4,0,4
"458","3679新至陞","110/07/06","永豐金-虎尾",0,4,-4
"459","3679新至陞","110/07/06","華南永昌-小港",4,0,4
"460","3679新至陞","110/07/06","台灣摩根士丹利",0,3,-3
"461","3679新至陞","110/07/06","元大-天母",4,0,4
"462","3679新至陞","110/07/06","瑞士信貸",0,3,-3
"463","3679新至陞","110/07/06","台中銀-員林",4,1,3
"464","3679新至陞","110/07/06","統一-新竹",0,3,-3
"465","3679新至陞","110/07/06","摩根大通",4,1,3
"466","3679新至陞","110/07/06","統一-三重",0,3,-3
"467","3679新至陞","110/07/06","凱基-台北",7,4,3
"468","3679新至陞","110/07/06","凱基-竹北",0,3,-3
"469","3679新至陞","110/07/06","華南永昌-高雄",3,0,3
"470","3679新至陞","110/07/06","元富-世貿",0,2,-2
"471","3679新至陞","110/07/06","永豐金-潮州",2,0,2
"472","3679新至陞","110/07/06","兆豐-鹿港",0,2,-2
"473","3679新至陞","110/07/06","合庫-新竹",1,0,1
"474","3679新至陞","110/07/06","玉山-台大",0,2,-2
"475","3679新至陞","110/07/06","土銀-高雄",1,0,1
"476","3679新至陞","110/07/06","國泰-館前",0,2,-2
"477","3679新至陞","110/07/06","元富-新興",1,0,1
"478","3679新至陞","110/07/06","群益金鼎-新莊",0,2,-2
"479","3679新至陞","110/07/06","富邦-中壢",1,0,1
"480","3679新至陞","110/07/06","元大-桃園",0,2,-2
"481","2727王品","110/07/06","第一金",62,0,62
"482","2727王品","110/07/06","台灣摩根士丹利",1,177,-176
"483","2727王品","110/07/06","凱基-埔墘",40,0,40
"484","2727王品","110/07/06","凱基-台北",49,151,-102
"485","2727王品","110/07/06","中國信託-忠孝",40,1,39
"486","2727王品","110/07/06","摩根大通",19,107,-88
"487","2727王品","110/07/06","玉山-板橋",40,6,34
"488","2727王品","110/07/06","美商高盛",2,86,-84
"489","2727王品","110/07/06","亞東-新竹",31,1,30
"490","2727王品","110/07/06","元大-北屯",1,52,-51
"491","2727王品","110/07/06","群益金鼎-宜蘭",25,1,24
"492","2727王品","110/07/06","國泰證券",1,47,-46
"493","2727王品","110/07/06","富邦-竹北",23,0,23
"494","2727王品","110/07/06","統一",3,33,-30
"495","2727王品","110/07/06","元大-旗山",23,0,23
"496","2727王品","110/07/06","第一金-台中",1,30,-29
"497","2727王品","110/07/06","元富-宜蘭",21,0,21
"498","2727王品","110/07/06","華南永昌-中正",4,29,-25
"499","2727王品","110/07/06","國票-長城",20,0,20
"500","2727王品","110/07/06","美林",0,23,-23
"501","2727王品","110/07/06","台新證券",47,28,19
"502","2727王品","110/07/06","群益金鼎-館前",0,20,-20
"503","2727王品","110/07/06","富邦-新竹華信",18,1,17
"504","2727王品","110/07/06","國票-內壢",0,16,-16
"505","2727王品","110/07/06","永豐金-中正",18,1,17
"506","2727王品","110/07/06","兆豐-新莊",0,15,-15
"507","2727王品","110/07/06","華南永昌-麻豆",17,1,16
"508","2727王品","110/07/06","港商野村",15,28,-13
"509","2727王品","110/07/06","永豐金-潮州",15,0,15
"510","2727王品","110/07/06","元大-善化",1,13,-12
"511","1570力肯","110/07/06","台新證券",88,0,88
"512","1570力肯","110/07/06","新光",0,54,-54
"513","1570力肯","110/07/06","摩根大通",49,15,34
"514","1570力肯","110/07/06","元大-高雄",0,40,-40
"515","1570力肯","110/07/06","合庫-桃園",20,0,20
"516","1570力肯","110/07/06","國票-北高雄",38,50,-12
"517","1570力肯","110/07/06","元大-土城學府",20,0,20
"518","1570力肯","110/07/06","群益金鼎-嘉義",0,10,-10
"519","1570力肯","110/07/06","永豐金-板盛",18,0,18
"520","1570力肯","110/07/06","元大-草屯",0,10,-10
"521","1570力肯","110/07/06","永豐金-永康",18,0,18
"522","1570力肯","110/07/06","日盛-高雄",0,9,-9
"523","1570力肯","110/07/06","統一-員林",14,0,14
"524","1570力肯","110/07/06","第一金-路竹",0,9,-9
"525","1570力肯","110/07/06","元大-竹山",6,0,6
"526","1570力肯","110/07/06","元大-古亭",0,9,-9
"527","1570力肯","110/07/06","統一-敦南",5,0,5
"528","1570力肯","110/07/06","國票-中正",0,8,-8
"529","1570力肯","110/07/06","元大-永和",5,0,5
"530","1570力肯","110/07/06","群益金鼎-鳳山",0,6,-6
"531","1570力肯","110/07/06","元富-大裕",4,0,4
"532","1570力肯","110/07/06","元大-土城永寧",0,6,-6
"533","1570力肯","110/07/06","華南永昌-斗六",4,0,4
"534","1570力肯","110/07/06","中國信託",0,5,-5
"535","1570力肯","110/07/06","永豐金-松山",6,3,3
"536","1570力肯","110/07/06","日盛-板橋",0,4,-4
"537","1570力肯","110/07/06","永豐金-南投",4,1,3
"538","1570力肯","110/07/06","日盛-木柵",0,4,-4
"539","1570力肯","110/07/06","土銀-彰化",2,0,2
"540","1570力肯","110/07/06","玉山-桃園",0,4,-4
"541","6180橘子","110/07/06","臺銀-金山",27,0,27
"542","6180橘子","110/07/06","凱基-台北",6,36,-30
"543","6180橘子","110/07/06","元富-潮州",20,0,20
"544","6180橘子","110/07/06","元大-天母",1,26,-25
"545","6180橘子","110/07/06","凱基-中山",20,0,20
"546","6180橘子","110/07/06","富邦-陽明",0,22,-22
"547","6180橘子","110/07/06","元大-太平",23,4,19
"548","6180橘子","110/07/06","日盛-頭份",0,20,-20
"549","6180橘子","110/07/06","摩根大通",17,0,17
"550","6180橘子","110/07/06","富邦-仁愛",0,20,-20
"551","6180橘子","110/07/06","元大-草屯",20,3,17
"552","6180橘子","110/07/06","永豐金-新莊",0,20,-20
"553","6180橘子","110/07/06","華南永昌-楠梓",15,1,14
"554","6180橘子","110/07/06","台灣摩根士丹利",0,18,-18
"555","6180橘子","110/07/06","中國信託-永康",12,0,12
"556","6180橘子","110/07/06","華南永昌-長虹",1,16,-15
"557","6180橘子","110/07/06","日盛-文化",10,0,10
"558","6180橘子","110/07/06","新光-新竹",0,12,-12
"559","6180橘子","110/07/06","國泰-館前",10,0,10
"560","6180橘子","110/07/06","凱基-中壢",0,12,-12
"561","6180橘子","110/07/06","華南永昌-鶯歌",10,0,10
"562","6180橘子","110/07/06","第一金-忠孝",0,11,-11
"563","6180橘子","110/07/06","元大-豐原站前",10,0,10
"564","6180橘子","110/07/06","元大-沙鹿",0,11,-11
"565","6180橘子","110/07/06","元大-北屯",10,0,10
"566","6180橘子","110/07/06","永豐金-羅東",0,11,-11
"567","6180橘子","110/07/06","兆豐-台中",10,1,9
"568","6180橘子","110/07/06","兆豐-埔墘",0,10,-10
"569","6180橘子","110/07/06","群益金鼎-開元",9,0,9
"570","6180橘子","110/07/06","華南永昌-台中",0,10,-10
"571","2390云辰","110/07/06","元大-向上",144,0,144
"572","2390云辰","110/07/06","摩根大通",18,674,-656
"573","2390云辰","110/07/06","元富-中港",102,0,102
"574","2390云辰","110/07/06","凱基-台北",141,625,-484
"575","2390云辰","110/07/06","群益金鼎-民權",104,4,100
"576","2390云辰","110/07/06","美林",32,261,-229
"577","2390云辰","110/07/06","兆豐-忠孝",81,0,81
"578","2390云辰","110/07/06","新加坡商瑞銀",50,149,-99
"579","2390云辰","110/07/06","合庫-新竹",60,0,60
"580","2390云辰","110/07/06","台灣摩根士丹利",7,87,-80
"581","2390云辰","110/07/06","元大-土城學府",59,1,58
"582","2390云辰","110/07/06","元大-金華",2,68,-66
"583","2390云辰","110/07/06","玉山-大里",58,3,55
"584","2390云辰","110/07/06","國票-新莊",13,65,-52
"585","2390云辰","110/07/06","元大-東蘆",54,1,53
"586","2390云辰","110/07/06","凱基-三重",12,56,-44
"587","2390云辰","110/07/06","元富-三重",51,0,51
"588","2390云辰","110/07/06","新光-台中",23,65,-42
"589","2390云辰","110/07/06","元富-埔里",50,0,50
"590","2390云辰","110/07/06","第一金-中壢",5,45,-40
"591","2390云辰","110/07/06","中國信託-三重",52,3,49
"592","2390云辰","110/07/06","華南永昌-斗六",0,40,-40
"593","2390云辰","110/07/06","元大-彰化民生",64,15,49
"594","2390云辰","110/07/06","富邦-新竹華信",25,61,-36
"595","2390云辰","110/07/06","元大-潮州",50,5,45
"596","2390云辰","110/07/06","玉山-新莊",2,32,-30
"597","2390云辰","110/07/06","元富-高雄",57,14,43
"598","2390云辰","110/07/06","凱基-新豐",17,47,-30
"599","2390云辰","110/07/06","凱基-和平",40,0,40
"600","2390云辰","110/07/06","統一-汐止",1,29,-28
"601","4903聯光通","110/07/07","元大-苗栗",10,0,10
"602","4903聯光通","110/07/07","宏遠證券",0,13,-13
"603","4903聯光通","110/07/07","彰銀",5,0,5
"604","4903聯光通","110/07/07","富邦-新營",0,4,-4
"605","4903聯光通","110/07/07","元大-松山",5,0,5
"606","4903聯光通","110/07/07","元富-草屯",0,3,-3
"607","4903聯光通","110/07/07","新光",3,0,3
"608","4903聯光通","110/07/07","元大-羅東",0,3,-3
"609","4903聯光通","110/07/07","群益金鼎-館前",1,0,1
"610","4903聯光通","110/07/07","元大-北三重",0,2,-2
"611","4903聯光通","110/07/07","華南永昌-鶯歌",1,0,1
"612","4903聯光通","110/07/07","國泰-敦南",0,1,-1
"613","4903聯光通","110/07/07","永豐金-市政",1,0,1
"614","4903聯光通","110/07/07","元富-板橋",0,0,0
"615","4903聯光通","110/07/07","元富-板橋",0,0,0
"616","4903聯光通","110/07/07","華南永昌",0,0,0
"617","4903聯光通","110/07/07","華南永昌",0,0,0
"618","4903聯光通","110/07/07","元大-太平",2,2,0
"619","4903聯光通","110/07/07","元大-太平",2,2,0
"631","2929淘帝","110/07/07","新光",204,85,119
"632","2929淘帝","110/07/07","港商野村",62,282,-220
"633","2929淘帝","110/07/07","日盛-中壢",94,0,94
"634","2929淘帝","110/07/07","摩根大通",64,264,-200
"635","2929淘帝","110/07/07","元富-城東",84,0,84
"636","2929淘帝","110/07/07","統一",0,163,-163
"637","2929淘帝","110/07/07","日盛-雙和",55,0,55
"638","2929淘帝","110/07/07","香港上海匯豐",0,141,-141
"639","2929淘帝","110/07/07","第一金-路竹",71,17,54
"640","2929淘帝","110/07/07","新加坡商瑞銀",54,179,-125
"641","2929淘帝","110/07/07","元大-花蓮",44,2,42
"642","2929淘帝","110/07/07","合庫-高雄",3,122,-119
"643","2929淘帝","110/07/07","永豐金-大園",73,33,40
"644","2929淘帝","110/07/07","美林",34,118,-84
"645","2929淘帝","110/07/07","元大-太平",44,6,38
"646","2929淘帝","110/07/07","元大-員林",2,82,-80
"647","2929淘帝","110/07/07","國泰-板橋",40,5,35
"648","2929淘帝","110/07/07","元富-松德",26,75,-49
"649","2929淘帝","110/07/07","兆豐-內湖",33,1,32
"650","2929淘帝","110/07/07","臺銀-臺南",9,52,-43
"651","2929淘帝","110/07/07","元大-博愛",43,11,32
"652","2929淘帝","110/07/07","元大-北投",5,48,-43
"653","2929淘帝","110/07/07","日盛-竹北",40,10,30
"654","2929淘帝","110/07/07","臺銀-民權",1,41,-40
"655","2929淘帝","110/07/07","元大-善化",52,22,30
"656","2929淘帝","110/07/07","兆豐-忠孝",1,41,-40
"657","2929淘帝","110/07/07","富邦-北港",29,0,29
"658","2929淘帝","110/07/07","元大-西門",1,36,-35
"659","2929淘帝","110/07/07","凱基-湖口",27,0,27
"660","2929淘帝","110/07/07","玉山-嘉義",3,35,-32
"661","5410國眾","110/07/07","兆豐-城中",28,0,28
"662","5410國眾","110/07/07","凱基-高美館",1,18,-17
"663","5410國眾","110/07/07","元大-小港",20,0,20
"664","5410國眾","110/07/07","國泰-館前",0,15,-15
"665","5410國眾","110/07/07","元大-新盛",18,0,18
"666","5410國眾","110/07/07","國泰-板橋",2,17,-15
"667","5410國眾","110/07/07","香港上海匯豐",15,0,15
"668","5410國眾","110/07/07","新光",0,13,-13
"669","5410國眾","110/07/07","華南永昌-小港",15,0,15
"670","5410國眾","110/07/07","元富-緯城",0,10,-10
"671","5410國眾","110/07/07","元富-大昌",13,0,13
"672","5410國眾","110/07/07","中農",0,10,-10
"673","5410國眾","110/07/07","臺銀-臺南",10,0,10
"674","5410國眾","110/07/07","凱基-屏東",0,10,-10
"675","5410國眾","110/07/07","元富-延平",8,0,8
"676","5410國眾","110/07/07","新光-桃園",0,6,-6
"677","5410國眾","110/07/07","元大-八德",17,9,8
"678","5410國眾","110/07/07","高橋-龍潭",0,5,-5
"679","5410國眾","110/07/07","摩根大通",7,0,7
"680","5410國眾","110/07/07","元富-世貿",0,5,-5
"681","5410國眾","110/07/07","凱基-桃園",7,0,7
"682","5410國眾","110/07/07","群益金鼎-瑞豐",0,5,-5
"683","5410國眾","110/07/07","永豐金-屏東",7,0,7
"684","5410國眾","110/07/07","富邦-台中",0,5,-5
"685","5410國眾","110/07/07","台新-左楠",5,0,5
"686","5410國眾","110/07/07","永豐金-板橋",0,5,-5
"687","5410國眾","110/07/07","富邦-竹東",5,0,5
"688","5410國眾","110/07/07","富邦-台南",0,4,-4
"689","5410國眾","110/07/07","元大-新莊",5,0,5
"690","5410國眾","110/07/07","凱基-站前",0,3,-3
"691","2841台開","110/07/07","群益金鼎-忠孝",100,0,100
"692","2841台開","110/07/07","港商野村",0,295,-295
"693","2841台開","110/07/07","台新證券",58,0,58
"694","2841台開","110/07/07","元大-善化",0,50,-50
"695","2841台開","110/07/07","台新-台中",58,0,58
"696","2841台開","110/07/07","元大-四維",0,50,-50
"697","2841台開","110/07/07","永豐金-敦南",50,0,50
"698","2841台開","110/07/07","台新-新營",0,30,-30
"699","2841台開","110/07/07","元大-台中",45,0,45
"700","2841台開","110/07/07","群益金鼎-桃園",0,21,-21
"701","2841台開","110/07/07","凱基-文心",43,0,43
"702","2841台開","110/07/07","台中銀-員林",0,20,-20
"703","2841台開","110/07/07","永豐金-潮州",30,0,30
"704","2841台開","110/07/07","群益金鼎-延平",0,15,-15
"705","2841台開","110/07/07","第一金-自由",25,0,25
"706","2841台開","110/07/07","元大-三重",0,13,-13
"707","2841台開","110/07/07","美商高盛",17,0,17
"708","2841台開","110/07/07","元富-古亭",0,10,-10
"709","2841台開","110/07/07","大昌-安康",39,22,17
"710","2841台開","110/07/07","群益金鼎-北高雄",0,10,-10
"711","2841台開","110/07/07","台中銀",15,0,15
"712","2841台開","110/07/07","華南永昌-南京",0,10,-10
"713","2841台開","110/07/07","玉山-嘉義",15,0,15
"714","2841台開","110/07/07","富邦-花蓮",0,10,-10
"715","2841台開","110/07/07","新光",11,0,11
"716","2841台開","110/07/07","富邦-高雄",0,10,-10
"717","2841台開","110/07/07","兆豐-永和",10,0,10
"718","2841台開","110/07/07","元大-竹山",0,10,-10
"719","2841台開","110/07/07","康和-內湖",10,0,10
"720","2841台開","110/07/07","元大-屏東",0,10,-10
"721","6207雷科","110/07/07","新光",45,4,41
"722","6207雷科","110/07/07","凱基-高美館",1,104,-103
"723","6207雷科","110/07/07","統一-基隆",30,0,30
"724","6207雷科","110/07/07","摩根大通",11,45,-34
"725","6207雷科","110/07/07","康和-南崁",13,0,13
"726","6207雷科","110/07/07","群益金鼎-新竹",0,22,-22
"727","6207雷科","110/07/07","宏遠-台南",10,0,10
"728","6207雷科","110/07/07","港商野村",2,23,-21
"729","6207雷科","110/07/07","國票-和平",10,0,10
"730","6207雷科","110/07/07","凱基-台北",0,14,-14
"731","6207雷科","110/07/07","永豐金-天母",10,0,10
"732","6207雷科","110/07/07","台新-三民",0,12,-12
"733","6207雷科","110/07/07","台新證券",10,1,9
"734","6207雷科","110/07/07","群益金鼎-開元",1,11,-10
"735","6207雷科","110/07/07","群益金鼎-士林",8,0,8
"736","6207雷科","110/07/07","富邦-南屯",0,8,-8
"737","6207雷科","110/07/07","群益金鼎-瑞豐",7,0,7
"738","6207雷科","110/07/07","元大-善化",0,8,-8
"739","6207雷科","110/07/07","元大-四維",7,0,7
"740","6207雷科","110/07/07","日盛-頭份",0,5,-5
"741","6207雷科","110/07/07","國票-中和",6,0,6
"742","6207雷科","110/07/07","第一金-高雄",0,5,-5
"743","6207雷科","110/07/07","台新-中壢",6,0,6
"744","6207雷科","110/07/07","凱基-八德",0,5,-5
"745","6207雷科","110/07/07","凱基-高雄",6,0,6
"746","6207雷科","110/07/07","凱基-頭份",0,5,-5
"747","6207雷科","110/07/07","富邦-彰化",6,0,6
"748","6207雷科","110/07/07","合庫-新竹",0,4,-4
"749","6207雷科","110/07/07","凱基-大安",5,0,5
"750","6207雷科","110/07/07","新光-高雄",0,4,-4
"751","3679新至陞","110/07/07","凱基",11,0,11
"752","3679新至陞","110/07/07","摩根大通",0,22,-22
"753","3679新至陞","110/07/07","台中銀-員林",11,1,10
"754","3679新至陞","110/07/07","凱基-台北",6,21,-15
"755","3679新至陞","110/07/07","安泰-大發",10,0,10
"756","3679新至陞","110/07/07","瑞士信貸",0,13,-13
"757","3679新至陞","110/07/07","香港上海匯豐",8,0,8
"758","3679新至陞","110/07/07","富邦-苗栗",0,10,-10
"759","3679新至陞","110/07/07","永豐金證券",8,2,6
"760","3679新至陞","110/07/07","元大-永春",0,6,-6
"761","3679新至陞","110/07/07","第一金-高雄",5,0,5
"762","3679新至陞","110/07/07","凱基-興隆",0,5,-5
"763","3679新至陞","110/07/07","群益金鼎-高盛",3,0,3
"764","3679新至陞","110/07/07","國泰-桃園",0,3,-3
"765","3679新至陞","110/07/07","元大-嘉義",3,0,3
"766","3679新至陞","110/07/07","元大-萬華",2,5,-3
"767","3679新至陞","110/07/07","臺銀-高雄",2,0,2
"768","3679新至陞","110/07/07","美林",0,2,-2
"769","3679新至陞","110/07/07","日盛-復興",2,0,2
"770","3679新至陞","110/07/07","第一金-華江",0,2,-2
"771","3679新至陞","110/07/07","日盛-樹林",4,2,2
"772","3679新至陞","110/07/07","新光-台中",0,2,-2
"773","3679新至陞","110/07/07","宏遠-館前",2,0,2
"774","3679新至陞","110/07/07","華南永昌-民權",0,2,-2
"775","3679新至陞","110/07/07","台新證券",2,0,2
"776","3679新至陞","110/07/07","元大-板橋",0,2,-2
"777","3679新至陞","110/07/07","康和-板橋",2,0,2
"778","3679新至陞","110/07/07","日盛-板橋中山",0,1,-1
"779","3679新至陞","110/07/07","群益金鼎-台南",2,0,2
"780","3679新至陞","110/07/07","宏遠證券",0,1,-1
"781","2727王品","110/07/07","元大證券",1033,729,304
"782","2727王品","110/07/07","台灣摩根士丹利",35,184,-149
"783","2727王品","110/07/07","富邦-台北",332,46,286
"784","2727王品","110/07/07","元大-北屯",11,79,-68
"785","2727王品","110/07/07","統一",252,43,209
"786","2727王品","110/07/07","元富-敦南",4,70,-66
"787","2727王品","110/07/07","永豐金-松山",147,14,133
"788","2727王品","110/07/07","元大-基隆孝二",11,75,-64
"789","2727王品","110/07/07","富邦-嘉義",301,198,103
"790","2727王品","110/07/07","臺銀-臺南",9,69,-60
"791","2727王品","110/07/07","新加坡商瑞銀",128,34,94
"792","2727王品","110/07/07","中國信託-忠孝",5,48,-43
"793","2727王品","110/07/07","元富-台南",97,6,91
"794","2727王品","110/07/07","永豐金-市政",5,46,-41
"795","2727王品","110/07/07","台新證券",169,105,64
"796","2727王品","110/07/07","彰銀-台中",19,56,-37
"797","2727王品","110/07/07","美林",115,58,57
"798","2727王品","110/07/07","玉山證券",30,67,-37
"799","2727王品","110/07/07","華南永昌",75,23,52
"800","2727王品","110/07/07","凱基-埔墘",4,41,-37
"801","2727王品","110/07/07","凱基-台北",445,398,47
"802","2727王品","110/07/07","永豐金-大園",3,40,-37
"803","2727王品","110/07/07","凱基-大直",48,7,41
"804","2727王品","110/07/07","元富",2,37,-35
"805","2727王品","110/07/07","凱基-林口",45,4,41
"806","2727王品","110/07/07","富邦-仁愛",32,64,-32
"807","2727王品","110/07/07","德信",40,1,39
"808","2727王品","110/07/07","玉山-板橋",52,82,-30
"809","2727王品","110/07/07","第一金",42,5,37
"810","2727王品","110/07/07","中國信託-文心",10,39,-29
"811","1570力肯","110/07/07","香港上海匯豐",47,0,47
"812","1570力肯","110/07/07","新光",2,107,-105
"813","1570力肯","110/07/07","元大-高雄",55,16,39
"814","1570力肯","110/07/07","摩根大通",11,58,-47
"815","1570力肯","110/07/07","元富-緯城",37,0,37
"816","1570力肯","110/07/07","高橋",4,50,-46
"817","1570力肯","110/07/07","台新-台南",16,0,16
"818","1570力肯","110/07/07","合庫-桃園",0,20,-20
"819","1570力肯","110/07/07","元大-新竹經國",14,0,14
"820","1570力肯","110/07/07","永豐金-板盛",0,18,-18
"821","1570力肯","110/07/07","富邦-左營",12,0,12
"822","1570力肯","110/07/07","華南永昌-公誠",0,9,-9
"823","1570力肯","110/07/07","國票-中正",12,2,10
"824","1570力肯","110/07/07","凱基-台北",1,9,-8
"825","1570力肯","110/07/07","國票-博愛",10,0,10
"826","1570力肯","110/07/07","臺銀-臺中",0,6,-6
"827","1570力肯","110/07/07","統一-敦南",12,5,7
"828","1570力肯","110/07/07","台新-三民",0,5,-5
"829","1570力肯","110/07/07","群益金鼎-三重",7,0,7
"830","1570力肯","110/07/07","華南永昌-麻豆",0,5,-5
"831","1570力肯","110/07/07","臺銀-臺南",6,0,6
"832","1570力肯","110/07/07","合庫-台南",0,4,-4
"833","1570力肯","110/07/07","大慶-蘆洲",6,0,6
"834","1570力肯","110/07/07","統一-員林",0,4,-4
"835","1570力肯","110/07/07","元富-新店",6,0,6
"836","1570力肯","110/07/07","康和-澎湖",0,4,-4
"837","1570力肯","110/07/07","玉山-雙和",7,1,6
"838","1570力肯","110/07/07","華南永昌-斗六",0,4,-4
"839","1570力肯","110/07/07","永豐金-敦南",9,3,6
"840","1570力肯","110/07/07","元大-和平",0,4,-4
"841","6180橘子","110/07/07","凱基-台北",72,12,60
"842","6180橘子","110/07/07","臺銀-金山",5,105,-100
"843","6180橘子","110/07/07","美林",29,0,29
"844","6180橘子","110/07/07","元大-台中",0,100,-100
"845","6180橘子","110/07/07","合庫-自強",21,0,21
"846","6180橘子","110/07/07","康和-台南",3,50,-47
"847","6180橘子","110/07/07","凱基-三峽",17,0,17
"848","6180橘子","110/07/07","元大-中和",0,35,-35
"849","6180橘子","110/07/07","富邦-虎尾",15,1,14
"850","6180橘子","110/07/07","中國信託-忠孝",0,16,-16
"851","6180橘子","110/07/07","元富-潮州",13,0,13
"852","6180橘子","110/07/07","玉山-高雄",0,12,-12
"853","6180橘子","110/07/07","中國信託-永康",13,0,13
"854","6180橘子","110/07/07","港商野村",0,11,-11
"855","6180橘子","110/07/07","元大-草屯",18,5,13
"856","6180橘子","110/07/07","群益金鼎-松山",0,11,-11
"857","6180橘子","110/07/07","臺銀",11,0,11
"858","6180橘子","110/07/07","永豐金-豐原",0,11,-11
"859","6180橘子","110/07/07","新光",15,4,11
"860","6180橘子","110/07/07","元富-嘉義",5,15,-10
"861","6180橘子","110/07/07","元大-竹東",11,0,11
"862","6180橘子","110/07/07","玉山-士林",0,10,-10
"863","6180橘子","110/07/07","宏遠-台中",10,0,10
"864","6180橘子","110/07/07","凱基-北門",0,10,-10
"865","6180橘子","110/07/07","第一金-台南",10,0,10
"866","6180橘子","110/07/07","第一金-忠孝",0,9,-9
"867","6180橘子","110/07/07","國泰-敦南",10,0,10
"868","6180橘子","110/07/07","統一-基隆",0,9,-9
"869","6180橘子","110/07/07","富邦-嘉義",10,0,10
"870","6180橘子","110/07/07","安泰-大發",1,10,-9
"871","2390云辰","110/07/07","元大-天母",975,276,699
"872","2390云辰","110/07/07","台灣摩根士丹利",3,265,-262
"873","2390云辰","110/07/07","摩根大通",688,312,376
"874","2390云辰","110/07/07","群益金鼎-海山",3,166,-163
"875","2390云辰","110/07/07","國泰-忠孝",164,3,161
"876","2390云辰","110/07/07","國泰-敦南",188,339,-151
"877","2390云辰","110/07/07","富邦-北港",140,7,133
"878","2390云辰","110/07/07","元大-土城學府",12,119,-107
"879","2390云辰","110/07/07","聯邦商銀",151,22,129
"880","2390云辰","110/07/07","永豐金-高雄",4,103,-99
"881","2390云辰","110/07/07","中國信託-文心",143,17,126
"882","2390云辰","110/07/07","土銀-士林",0,94,-94
"883","2390云辰","110/07/07","永豐金-中正",133,7,126
"884","2390云辰","110/07/07","元大-佳里",11,91,-80
"885","2390云辰","110/07/07","群益金鼎-大興",178,76,102
"886","2390云辰","110/07/07","玉山-台中",10,86,-76
"887","2390云辰","110/07/07","元富-中港",103,3,100
"888","2390云辰","110/07/07","新光",251,324,-73
"889","2390云辰","110/07/07","統一-新台中",104,12,92
"890","2390云辰","110/07/07","富邦-敦南",29,101,-72
"891","2390云辰","110/07/07","新加坡商瑞銀",211,120,91
"892","2390云辰","110/07/07","兆豐-台中",0,58,-58
"893","2390云辰","110/07/07","兆豐-忠孝",100,11,89
"894","2390云辰","110/07/07","日盛證券",16,73,-57
"895","2390云辰","110/07/07","凱基-林口",87,9,78
"896","2390云辰","110/07/07","元大-東泰",5,61,-56
"897","2390云辰","110/07/07","元富-西松",72,4,68
"898","2390云辰","110/07/07","台新證券",136,190,-54
"899","2390云辰","110/07/07","台新-左楠",66,9,57
"900","2390云辰","110/07/07","元大-六合",10,63,-53
